 , , , , , , , , , ,  
 , , , , , , , , , ,  
 , ,b,b,b,b,b, , , ,  
 , ,b,r, , ,b, , ,B,  
 , ,b, , , ,b, , , ,  
 , ,b,b,b, ,b, ,b, ,  
 , , , ,b, , , ,b, ,  
 , , , , , , , ,b, ,  
 , , ,b,b,b,b, ,b, ,  
 , , , , , , , , , ,  
 , , , , , , , , , ,  